1
58
30
#########################################################
#*******************************************************#
#*******************************************************#
#**************************...**************************#
#***.***************************************************#
#********************+**********************************#
#*******************************************************#
#*******************************************************#
#*******************************************************#
#*******************************************************#
#*******************************************************#
#*******************************************************#
#******+*******************************+****************#
#*******************************************************#
#*****************.*************************************#
#***********************************@*******************#
#*************************************************.*****#
#*******************************************************#
#*******************************************************#
#****** +++ ********************************************#
#****** *** **************************+*****************#
#*******************************************************#
#*******************************************************#
#*******************************************************#
#*******************************************************#
#**********+************.*******************************#
#*******************************************************#
#*******************************************************#
#*******************************************************#
#########################################################
