2
58
30
#########################################################
#*******************************************************#
#*******************************************************#
#**************************...**************************#
#***.***************************************************#
#********************+**********************************#
#*******************************************************#
#*******************************************************#
#*******************************************************#
#*******************************************************#
#*******************************************************#
#*******************************************************#
#******+*******************&    *******+****************#
#**************************&    ************************#
#*****************.********&    ************************#
#*******************************************************#
#*************************************************.*****#
#*******************************************************#
#******   $ ********************************************#
#****** +++ ********************************************#
#****** *** **************************+*****************#
#******$    ********************************************#
#*******************************************************#
#******************************************@************#
#*******************************************************#
#**********+************.*******************************#
#*******************************************************#
#*******************************************************#
#*******************************************************#
#########################################################
