4
56
28
#######################################################
#*****************************************************#
#*****************************************************#
#**^*******************.............******************#
#***********************...........*******************#
########################**********#####################
#*****************************************************#
#*****************************************************#
#*****************************************************#
#*****************************************************#
#*****************************************************#
#*****************************************************#
#************************&&&&&  *******+**************#
#************************&&&&&  **********************#
#*****************.******&&&&   **********************#
#************************&&&&&&&**********************#
#************************       ******************.***#
#*****************************************************#
#******     ******************************************#
#****** +++ ******************************************#
#****** *** ******************************************#
#******$$$$$******************************************#
#*****************************************************#
#******************************************@**********#
#*****************************************************#
#**********+************.*****************************#
#*****************************************************#
#######################################################
